###########################
#JMMMM##MMMMMMMMCMM##MMMMM#
#M#MMMMMM####D####MMBMMM#M#
#M###M#M##MBMMMM#####M###M#
#MCMMMOMMDM####MDMMMAMMMOM#
#######D##M####M#M####A####
#MMOMMMMMMM####MDMMMMMMOMM#
#M####AM#M#MMMMM#M#D##M##D#
#MMMMMMM#M#######M#MMMMOMM#
##C##M#MMMMMMMMMMA#MMC#MM##
###########################