###########################
#MCMM###MM#MMCMMMMMMDMMMMM#
#MMMMOM#MB#MM#OMMM###M###M#
######A#MMMM##MMMM##MMMMMM#
#MMMMMMMCMMMM#######M#MM#M#
#MMMMM##MMMMMMMMMMMDM#MM#O#
####M####MMMMMM######MDBCM#
#OMMMMMM#MMMMMM#MOMM#M#####
#MMMMB###A######MMMMMMMMMM#
##CMMDMMMMMMMMMMMMMM###MMJ#
###########################